#.#..#..#.
##..#..#..
.#.....##.
#..#......
###......#
#..##...##
.#........
.##......#
.#..#....#
...##...##
!